NO ./images/wall_low_poly_64x64_1.png
SO ./images/wall_low_poly_64x64_2.png
WE ./images/wall_low_poly_64x64_3.png
EA ./images/wall_low_poly_64x64_4.png

F 112,173,67
C 135,206,250



11111111111111111111111111111111111111
10000000001100000000000000000000000001
10111111001111111111111111101111111001
10100001000000000000001110000000001011
10101111011111101111101110111111001001
10100000010000100000100010100001001101
10101111110111101110111010111001001001
10100000010000000010100010100001001011
10111111011111111110111010101111001001
10000001000000000000001010100000001101
10111101111101111111011010111111001001
10000000000001000001000000000000001011
10111111011111011101111111101111111001
10000001000000000000000000100000000001
11111001101111111111111110111111111001
10001000000000000000000010000000001001
10101110101111101111111110111111010001
10100000101000100000000010001000010S01
10111111100010101111111110101111110001
11111111111111111111111111111111111111